UPL Reporting Names

=Terrans=
Marine -> Grunt
Medic -> Unchanged
Marauder -> Tank Hunter
Firebat -> Scorcher
Reaper -> Jumper
Ghost -> Sniper
Spectre -> Psycho
Hellion -> Firebuggy
Hellbat -> Firebeetle
Vulture -> Mad Dog
Goliath -> Grison
Siege Tank -> Akatsiya
Predator -> Panther
Diamondback -> Hellcat
Thor -> Ettin
Viking -> Shifter
SC1 Dropship -> Airbus
Medivac -> Healbus
Banshee -> Hind
Wraith -> Spirit
Science Vessel -> Spanner
Raven -> Nomad
Hercules -> Heavy Transport
Battlecruiser -> Unchanged
SCV -> Loader
Widow Mine -> Popper
Liberator -> Dark Angel
Cyclone -> Archer

=Zerg=
Baneling -> Boomer
Corruptor -> Squid
Devourer -> Splasher
Brood Lord -> Mother Manta
Infestor -> Snail
Overseer -> Eyeballer
Changeling -> Spy
Swarm Host -> Beehive
Viper -> Dragonfly
Ravager -> Bombardier
Aberration -> Brute
Impaler -> Bad Vlad
Brutalisk -> Juggernaut
Leviathan -> Kraken Moon

=Protoss=
Probe -> Planter
Zealot -> Swordsman
Dragoon -> Cannoneer
Stalker -> Flash
Sentry -> Shielder
High Templar -> Stormpriest/Warlock
Dark Templar -> Assassin
Archon -> Stormcloud
Dark Archon -> Enslaver
Shuttle/Warp Prism -> Ferry
Immortal -> Dreadnought
Reaver -> Slugger
Colossus -> Conflagrator
Scout -> Corvette
Phoenix -> Lifter
Void Ray -> Beamer
Arbiter -> Nightfall
Carrier -> Hornet Nest
Mothership -> Star City